F 29,206,195
C 64,64,64

NO ./images/wall1.png
SO ./images/wall2.png
WE ./images/wall3.png
EA ./images/wall4.png



1111111111111
1N00000110001
1000110000001
1110000000001
1111111111111
