F 29,206,195
C 64,64,64

NO ./textures/bluestone.xpm
SO ./textures/mossy.xpm
WE ./textures/wood.xpm
EA ./textures/colorstone.xpm


1111111001111
1N00000110001
1011111011111
1000000000001
1111111111111

1111111001111
1000000110001
1011111011111
1000000000001
1111111111111