NO ./textures/bluestone.xpm
SO ./textures/mossy.xpm
WE ./textures/wood.xpm
EA ./textures/colorstone.xpm

F 29,206,195
C    64,64,64

111111111111111111111111
110001000001000000000001
101001001000000000000001
100000000001000000000001
111011110111111111111111
100000000000010000000001
100001000010000010000001
10000N000000010000000001
111111111111111011111111
100000000000000000000001
100100000000010010000001
100100000000010000000001
111111111111111011111111
100010000000000000000001
100000000001000000000001
100000000000000000000001
100000100000000010000001
100000100000000000000001
100000111100000000000001
100000000000010000000001
100010000000000000000001
111111111111111111111111
