NO ./images/wall1.png
SO ./images/wall2.png
WE ./images/wall3.png
EA ./images/wall4.png

F 29,206,195
C    64,64,64

111111111111111111111111
100001000001000000000001
100001001000000000000001
100000000001000000000001
111011110111111111111111
100000000000010000000001
100000000010000010000001
100000000000010000000001
111111111111111011111111
100000000000000000000001
100100000000010010000001
100100000000010000000001
111111111111111011111111
100010000000000000000001
100000000001000000000001
100000000N00000000000001
100000100000000010000001
100000100000000000000001
100000111100000000000001
100000000000010000000001
100010000000000000000001
111111111111111111111111
