F 47,50,52
C 64,64,64

NO ./textures/bluestone.xpm
SO ./textures/mossy.xpm
WE ./textures/wood.xpm
EA ./textures/colorstone.xpm



111111111111111111111111
100000100000001000000001
100100111110001000100011
100000100000001000100011
110111111111111111111111
100000000001000000000001
100011111001000000000001
101110001001000000000001
100000000000000000000001
100000000000000000000001
100000000000000000000001
100000000000000000000001
10000000000S000000000001
111111111111111111111111
