F 29,206,195
C 64,64,64

NO ./textures/bluestone.xpm
SO ./textures/mossy.xpm
WE ./textures/wood.xpm
EA ./textures/colorstone.xpm



1111111111111111111111111111111111111111111111111111111111111111
1000010000010000000000010000000000000000000000000000000000000001
1000000000000000000000010000000000000000000000000000000000000001
1000010000010000000000010000000000000000000000000000000000000001
1111111011111111110111110000000000000000000000000000000000000001
1000000000000100000000010000000000000000000000000000000S00000001
1000000000000100000000010000000000000000000000000000000000000001
1000000000000100000000010000000000000000000000100000000000000001
1111111011111111110111111111111111110111111111111111111111111111
1000000000000000000000010000000000000000000000100000000000000001
1001000000000100000000000000000000000000000000000000000000000001
1001000000000100000000010000000000000000000000100000000000000001
1111111011111111110111111111111111110111111101110111111111111111
1000000000000000000000010000000000000000000000100000000000000001
1000000000000000000000010000000000000000000000000000000000000001
1000000000000000000000010000000000000000000000100000000000000001
1000000000000000000000010000000000000000000000100000000000000001
1000000000000000000000000000000000000000000000100000000000000001
1000000000000000000000010000000000000000000000100000000000000001
1000000000000000000000010000000000000000000000100000000000000001
1000000000000000000000010000000000000000000000100000000000000001
1111111111111111111111111111111111111111111111111111111111111111
