F 29,206,195
C 64,64,64

NO ./textures/bluestone.xpm
SO ./textures/mossy.xpm
WE ./textures/wood.xpm
EA ./textures/colorstone.xpm



11111
10101
11E11
10101
11111
