F 29,206,195
C 64,64,64

NO ./images/wall1.png
SO ./images/wall2.png
WE ./images/wall3.png
EA ./images/wall4.png



11111111111
10000000001
10001010001
10100000101
10000N00001
10100000101
10001010001
10000000001
11111111111
