NO ./textures/texture1.xpm
SO ./textures/texture2.xpm
WE ./textures/texture3.xpm
EA ./textures/texture4.xpm

F 85,85,85
C 74,9,255

        1111111111111111111111111
        1000000000110000000000001
        1011000001110000000000001
        100100000000000000000001
011111111011000001110000000000001
100000000011000001110111101111111
11110111111111011100000010001
11110111100111011101010010001
11000000110101011100000010001
10000000000000001100000010001
100000N0000000001101010010001  
1100000111010101111101111000111
11110111 1110101 101111010001
11111111 1111111 11111 111111