NO ./textures/texture1.xpm
SO ./textures/texture2.xpm
WE ./textures/texture3.xpm
EA ./textures/texture4.xpm

F 85, 85, 85
C 174, 191, 200

11111
10001
10N01
10001
11111