NO ./textures/bluestone.xpm
SO ./textures/mossy.xpm
WE ./textures/wood.xpm
EA ./textures/colorstone.xpm

F 85,85,85
C 174,191,200

11111
10001
10N01
10001
11111