F 206,23,45
C 64,64,64

NO ./textures/bluestone.xpm
SO ./textures/mossy.xpm
WE ./textures/wood.xpm
EA ./textures/colorstone.xpm

111111     1111111111111
100001     1000000000001
100001111111000000000001
100000000000000000000001
111111101111111111011111
1000000000S0010000000001
100000000000010000000001
100000000000010000000001
111111101111111111011111
100000001    10000000001
100100001    10000000001
100100001    10000000001
111111101111111111011111
100000000000000000000001
100000000000000000000001
100000000000000000000001
100000000000000000000001
100000000000000000000001
100000000000000000000001
100000000000000000000001
100000000000000000000001
111111111111111111111111
