NO ./textures/bluestone.xpm
SO ./textures/mossy.xpm
WE ./textures/wood.xpm
EA ./textures/colorstone.xpm



F 64,64,64
C 64,64,64

1111111111111111111111111
1000000000001000000000001
1000000000001000000000001
1000000000000000000000001
1000000000001000000000001
1000000000001000000000001
1111110111111111111111111
    10001
    10001
    10001
    10001
    10001
    10001
  111000111
  100000001
  111000111
    10001
    10001
1111110111111
1000000000001111111111111111111111111111111
1000000000001000000000001000000000000000001
1000000000000000000000000000000000000000001
1000000000001000000000001000000000000000001
1000000000001110000000011000000000000000001
1111110111111111100011111111101111111011111
    100011111111100011111111111111111111111
    10001111111110001
    10001111111110001
    10001111111110001
    10001101001000001
    10001000000011111
    1000110100101
    1000111111111
    10001
    10001
    10001
    10001
    10001
    10001
    10001
1111110111111
1000100010001
1000000000001
1000100010001
1111100011111
1000100010001
10E0000000001
1000100010001
1111100011111
1000000000001
1000000000001
1111111111111
