f 29,206,195
C 12,11,64

NO ./textures/bluestone.xpm
SO ./textures/mossy.xpm
WE ./textures/wood.xpm
EA ./textures/colorstone.xpm

       111111111111111111111111111
1111111100010000000000000000000001
1100011000010000000000011111111111
100000000000000000000001
100001000001000000000001
111111101111111111011111
100000000000010000000001
100000000000010000000001
111111111000001000000001
        11111110111111111111111111111111111111111111111111111
        10000000000000000000000100000000000000000000000000001
        10010000000001000000000000000000000000000000000000001
        10010000000001000000000100000000000000000000000000001
1111111111111111110111111111111111111111111111111111111111111
100000000000000000000001
1000N0000000000000000001
100000000000000000000001
100000000000000000000001
100000000000000000000001
100000000000000000000001
100000000000000000000001
100000000000000000000001
111111111111111111111111
