F 47,50,52
C 64,64,64

NO ./textures/bluestone.xpm
SO ./textures/mossy.xpm
WE ./textures/wood.xpm
EA ./textures/colorstone.xpm

11111111111111111111
10000000000000000001
10000000000000000001
10000000000000000001
10000000000000000001
10000000000000000001

10000000000000000001
10000000000000000001
10000000000000000001
1000000000000000N001
10000000000000000001
10000000000000000001
10000000000000000001
11111111111111111111
