F 29,206,195
C 64,64,64

NO ./textures/aaaa.xpm
SO ./textures/mossy.xpm
WE ./textures/dd.xpm
EA ./ds/colorstone.xpm


111111111111111111111111
100001000001000000000001
10E001000001000000000001
100001000001000000000001
111111111111111111111111
100000000000010000000001
100000000000010000000001
100000000000010000000001
111111111111111111111111
100100000000010000000001
100100000000010000000001
100100000000010000000001
111111111111111111111111
100000000000000000000001
100000000000000000000001
100000000000000000000001
100000000000000000000001
100000000000000000000001
100000000000000000000001
100000000000000000000001
100000000000000000000001
111111111111111111111111
